19,20,20,20,20,20,20,20,20,20,20,20,20,21
22,29,30,17,35,36,27,28,15,16,17,31,32,23
22,11,12,18,33,34,9,10,7,8,18,13,14,23
22,0,0,0,0,0,0,0,0,0,0,0,0,23
22,0,1,2,3,0,0,0,0,1,2,3,0,23
22,0,4,5,6,0,0,0,0,4,5,6,0,23
22,0,0,0,0,0,0,0,0,0,0,0,0,23
22,0,0,0,0,0,0,0,0,0,0,0,0,23
22,0,1,2,3,0,0,0,0,1,2,3,0,23
22,0,4,5,6,0,0,0,0,4,5,6,0,23
22,0,0,0,0,0,0,0,0,0,0,0,0,23
24,25,25,25,25,25,25,25,25,25,25,25,25,26
