4,8,8,14,15,8,12,8,8,5
10,24,25,16,17,26,13,18,19,11
10,22,23,0,0,27,0,0,20,11
10,0,0,0,0,28,0,0,21,11
10,0,0,0,0,0,0,0,0,11
10,0,0,0,0,0,0,0,0,11
6,1,2,9,9,9,9,9,9,7
3,3,3,3,3,3,3,3,3,3
